a (n): letter a
abalagjo (v): to put away, to stow away, guardar, to set aside
Abdīa (m): Abdiah, Abdias, Obadiah, Obadias
abjōn (f): ebb, low tide
abōl (m): fruit, apple
abolφeros (adj): fruit-bearing, pomiferous
Abram (m): Abram
Abrāmos (m): Abraham
abussos (m): abyss
agalajtīan (n): licentiousness
agalajtjos (adj): licentious
agalistrīōn (f): magpie, woodpecker
Aggajos (m): Haggai
agesīo (v): to sin
agestēr (m): sinner
agiθōn (f): harrow
agisiθa (f): fear, dread, horror, terror
agiso (v): to frighten, to terrify
agitaksīōn (f): lizard
agjo (v): to harrow
aglīo (v): to damage; to offend
ago (v): to fear, to be afraid, to be afraid of
agos (n): fault, sin
agros (m): flood
adalos (m): filth, urine, liquid manure, mud, mire
Ādām (m): Adam
adetēr (m): leader, commander
adetis (f): control
adetrīa (f): leadership
adis (f): cereal
admirāl (m): admiral
ado (v): to lead, to drive, to guide, to command, to control
Adrjānos (m): Hadrian, Adrian
adros (m): field
aθeros (m): ocean
ajatos (adj): metallic
ajgīa (f): sickness, illness
ajglos (n): shoot, barb
ajgōn (f): property, possessions
ajgos (adj): sick, ill
Ajguptos (f): Egypt
Ajdao (m): Idaho
ajdīan (n): isthmus
ajdīo (v): to ignite, to set on fire
ajeri (adv): early, in the morning
ajθos (m): oath
Ajkaterīna (f): Catherine
ajkilōn (f): acorn
ajkīo (v): to irritate, annoy, bother
ajktēr (m): possessor, owner
ajktro (v): to beg
Ajkwātōr (m): Ecuador
ajkwernōn (m): squirrel
Ajlaga (f): Olga
Ajlagos (m): Oleg (Holy, from Proto Germanic)
ajlan (n): ash, ashes
ajlīo (v): to kindle
Ajmarīk (m): Henry
ajmos (m): steam, smoke
ajmos (n): copy, image
ajmusjōn (f): ember, hot ash, pyre
ajnakos (m): orphan
ajnīos (m): juniper
ajos (n): copper
Ajowa (f): Iowa
ajrōn (f): oar
ajrundīan (n): message, errand
ajrus (m): messenger, servant, herald
ajsīo (v): to honor
ajska (f): demand, question
ajso (v): to rush
ajsōn (f): fireplace
ajsōn (f): honor, reverence, fear
ajstan (n): testicle
ajstīo (v): to respect
ajstos (m): kiln
ajtis (f): part
ajtomi (v): to possess, to own, to have
ajtos (m): ulcer
ajtos (n): spear, pike
ajtran (n): boil, sore; purulent matter, pus; poison
ajtu (n): oak
ajwa (f): vital force
ajwe (adv): always, forever, for eternity
ajwīo (v): to graze
aksla (f): axle, axis
akta (f): consideration, attention
Alabāma (f): Alabama
alasna (f): awl
Albertos (m): Albert
Albis (f): river Elbe, of Germany
albis (m): elf, fairy
albitis (f): swan
algis (m): elk
aldōn (f): canoe, boat
Aleksandros (m): Alexander
alinōn (f): elbow
alisōn (f): alder
aljanos (adj): zealous, eager; strong, courageous
Aljāska (f): Alaska
aljos (pn): other ** this is an adj
aljos (adj): other
alkōn (f): auk, a kind of sea bird
alnīa (f): difference
alnos (adj): different
alo (v): to nourish, to feed
alu (n): beer, ale
aluminjom (n): aluminium, aluminum
alutu (n): beer
alφos (adj): white
alxis (m): shelter, building; temple, sanctuary; settlement, residence
Ambakkūm (m): Habakkuk
ambis (f): eel
ambrīos (m): bucket
Amerika (f): America
Amerikiska Samoa (f): American Samoa
ammōn (m): stone
ammonatos (adj): stony, hard
Amōs (m): Amos
amφatos (adj): slithering
amφis (m): snake
amφros (m): rain
an (n): air
ana (pp): (loc) on; (acc) up (up the stream), along (along the road); (acc) during, along (e.g. along the last few days)
anadōn (m): anger
anatis (f): duck
anawītsentos (adj): envious, envying
anawītsinnos (adj): enviable
anawītso (v): to envy
anaφeltos (m): anvil
angasos (m): worry, grief, anxiety
angeliskos (adj): angelic
angelos (m): angel
Angliska (f): English language
angōn (m): spear, dart, hook
angos (m): ankle
angros (m): meadow, lowland
angustjos (adj): narrow, tight
Andrēa (m): Andrew
Andrēa (f): Andrea
andurdīan (n): answer, reply
anduros (m): snowshoe
anemos (m): breath
anθus (adj): narrow, tight
anīomi (v): to find
anjos (adj): old
ankatos (adj): sharp, cutting
ankīōn (f): hip
ankos (n): angle
ankula (f): belt, strap, band
ankwōn (m): ointment, butter
Anna (f): Anna
annīan (n): stuff, material
annīo (v): to perform, to execute
annos (m): lamb
anomi (v): to breathe
ans (pp): (gen) without
ansīōn (f): handle
anslōn (f): blackbird, yellowhammer
anstis (f): favor, affection
antān (m): ancestor, predecessor, forefather
anti (adv): forward
anti (pp): (loc) in front of; (acc) towards, in the direction of; (gen) before (time)
antiman (n): commencement, start, beginning
antīo (v): to begin, to commence, to start (transitive)
antis (f): front
antis (f): breath
antistao (v): to stand against, to resist
antiwītso (v): to foresee; to guess; to divinate
antjos (m): front, forehead
Antōnjos (m): Anthony
antūktēr (m): prophet
apaldros (m): apple tree
apastao (v): to remain
apo (pp): (abl) from; (acc) moving away from
apolūdo (v): to lose something, someone; to lose a battle, a game, or something
apōn (m): ape, monkey
apos (adj): liquid
aposomi (v): to be absent, to be away, to be distant
apostis (f): absence, scarcity
aposwepomi (v): to send away, discharge, dismiss, release, let go, throw away, discard, get rid of, shred, give up
apoteletis (f): uncovering, discovery, finding, revelation, apocalypse
apotelo (v): to uncover, to discover, to find, to reveal
apotelo (v): to open
apoxeφo (v): to take off, to take away, to remove
Aprīlis (m): April
apsa (f): aspen
apsis (f): axe
apsolūtos (adj): absolute
ar (pp): (acc) because of, thanks to
Arabīa (f): Arabia
Arabiska (f): Arabic language
arbajdis (f): suffering, toil, hardship
arbīan (n): heritage, inheritance
arbīōn (m): heir
arbos (m): working animal, ox
Argentīna (f): Argentina
ārgom (n): argon
aris (f): nut
Arisōna (f): Arizona
aritmētika (f): arithmetic
Arkānsa (f): Arkansas
arkaros (m): lock, safe, castle, fortified building, fort
arkomi (v): to lock
armāta (f): army
Armenīa (f): Armenia
armis (f): arm
armonīa (f): harmony
armoniskos (adj): harmonic
aro (v): to plough
Ārōn (m): Aaron
arotrom (n): instrument for ploughing
arpu (n): bow and arrow, arc, bow
artiskos (adj): northern, related to bears
Artobomos (m): (proper name) strong bear
Artoθorsos (m): (proper name) courageous bear
Artokretos (m): (proper name) clever bear
artōn (f): wagtail
Artonēr (m): (proper name) powerful bear
artos (m): bear
arutis (f): ore
arwos (n): scar
arφōn (m): chickweed
arxaīa (f): antiquity
arxajos (adj): archaic, ancient, old
arxeman (n): beginning, start
arxīwom (n): archive
asanis (f): summer, harvest time, harvest
asgēn (m): breast, teat
Aserbajān (m): Azerbaijan
Asīa (f): Asia
asjōn (f): soapstone
askagīan (n): stem (of a ship)
askajdila (f): crown
askajθis (f): sheath
askakulos (m): link in a chain, chain link
askalja (f): shell
askandjom (n): scandium
askando (v): to leap
askapos (n): tool
askaptos (m): shaft
askawnos (adj): beautiful, shining
askeldus (m): shield
askeljo (v): to owe, to must, to ought
askīdomi (v): to cut
askinkōn (m): thigh, shank
askjentīa (f): science
askjentiskos (adj): scientific
askōgos (m): forest
askorpjōn (m): scorpion
askos (m): ash tree
askotsja (m): scotch
askōxos (m): shoe
askrawda (f): piece, shred
askula (f): debt, obligation
askuldis (f): fault, guilt, blame
askurdis (f): cutting, shearing
askurtīōn (f): skirt
askuφla (f): shovel
asmeka (f): chin
asmeltos (m): smelt (fish)
asmerilos (m): merlin
asmeru (n): grease
asmīo (v): to laugh
asneggōn (m): snail
asneo (v): to laugh
asnidan (n): cutting, slice, piece
asnīφos (m): snow
asnōda (f): rope, string
asnomi (v): to swim
asnūan (n): sinew, tendon
asnūθos (n): mist
asnusa (f): daughter-in-law
asnūtos (m): snout
asnuttus (m): nasal mucus, snot
aspalus (m): splinter
aspanga (f): brooch, clasp
asparwos (m): sparrow
aspe (c): for, because
aspekjālis relātīwitāt (f): special relativity
aspekjālus (adj): special
aspekjertis (f): appearance
aspekjo (v): to look at, to regard
aspellan (n): news, message
aspergos (m): sparrow
aspēs (f): prosperity, luck
aspēso (v): to prosper, to be lucky
aspewtos (m): spear
aspikan (n): bacon
aspiktos (m): woodpecker
aspilan (n): dance
aspinθrōn (m): spider
aspinnila (f): spindle
aspīo (v): to spy
aspīrōn (f): top, peak, summit
aspjōn (m): spy
aspjōnīa (f): esponage
asplenθos (n): spleen
aspōdis (f): rush, hurry
aspōlōn (f): spool, reel
aspotus (m): lord, master, sir
aspūo (v): to spit
aspurōn (m): spur
astabiljo (v): to establish
astaggīos (m): stag
astajgris (m): scaffold, platform; stairs (in plural), step (of stairs, in singular)
astakōn (m): stake
astantom (n): tin
astao (v): to stand
astego (v): to cover
astēr (m): star
Asteφanos (m): Stephen
asteφo (v): to stiffen
astīgo (v): to puncture, to pierce
astigōn (f): slope, ramp
astimbos (n): firmness, firmament
astis (f): essence, being
astīxo (v): to climb
astōdan (n): herd of horses
astrajkos (m): line
astrampos (m): stem, stalk
astranda (f): edge, rim
astrawan (n): straw (for animals)
astrenxo (v): to twine
astreφo (v): to gulp, to swallow
astrīdos (m): battle, fight
astroφo (v): to sip, to suck
astrūjos (adj): easy, facile
astrūo (v): to flow
astubbos (m): stump, stub
astūo (v): to hit
asturis (m): turmoil, confusion, noise
asturjōn (m): sturgeon
asturkos (m): stork
asφajra (f): sphere
asφajriskos (adj): spherical
asxola (f): school
asxolārus (adj): scholar
ati (c): but, yet
atomiskos (adj): atomic
atomos (m): atom
atus (adj): sharp
awa (f): grandmother
awadīa (f): eider
Awāj (m): Hawaii
awgo (v): to enlarge
awgomi (v): to glance
Awgustos (m): Augustus, August
awdos (m): wealth, riches
awθār (f): udder
awida (f): oat
awis (f): bird
awistran (n): herd, flock
awja (f): island
awomi (v): to help
awos (m): grandfather
awris (f): river bank, sand bank at the river’s mouth, delta
awse (adv): tomorrow
awsiskos (adj): eastern
Awsodonos (m): (proper name) gift of the dawn
Awsōs (f): (proper name) dawn
awsōs (f): dawn, morning
awtomatom (n): automaton
aφerōn (m): offspring, descendant, successor
aφlan (n): power, strength, might
aφlos (m): hearth
Āφrika (f): Africa
axana (f): chaff, awns
axos (n): ear (of grain)
axos (n): distress, fear
axurnos (m): maple
axwa (f): stream, tributary, riachuelo, small river, brook
Babulōn (f): Babylon
badjan (n): grave
baθetos (adj): sunken
baθo (v): to sink
bajros (m): boar
bajtilos (m): chisel
bakis (f): beach
bakom (n): staff
balwos (adj): sick; bad, evil, wicked; torturous, painful, agonizing
bangilos (m): a stick, club
bandis (f): fetter
bankis (f): bulge
bankōn (m): hill
banōn (m): murderer, killer, slayer
bansos (m): crib, cradle; barn; stall (for animals)
bao (v): come
Barθolomajos (m): Bartholomew
barnan (n): child
barsos (m): perch
barugos (m): castrated boar
Barūk (m): Barak, Baruch
barwos (m): pine, pinetree, conifer
bastēr (m): walker
bastīo (v): to cause to walk
basto (v): to walk
bastos (m): rope, fiber
bawgos (m): ring, bracelet, collar, crown
be (n): letter b
belīa (f): force, strength
belisos (adj): stronger, more powerful, comparative of belos
bellōn (f): bell
Belorussīa (f): Belarus
belos (adj): powerful, strong
belφa (f): womb
bena (f): woman
Benjāmīn (m): Benjamin
benomi (v): to step, to take a step
bentis (f): step, the act of walking
bentom (n): floor, ground
bera (f): mount, mountain, hill
beretis (f): praise, glory
berjos (adj): praiseworthy, commendable
Berlīn (m): Berlin
bermōn (m): yeast
bero (v): to praise, to glorify
beru (n): spear
beru (n): millstone
beruka (f): mountain range
bērulljom (n): beryllium
besamōn (m): broom
betu (n): resin
bewdos (m): table
bewsan (n): beer
Biblja (f): Bible
bibljoθēka (f): library
bibljom (n): book
bikja (f): pickaxe
bikkilos (m): a die, dice
biliθjan (n): picture, image, likeness; pattern; example
biljan (n): spike, nail
birilōn (m): barrel
bīwo (v): to live
bīwos (m): life
bīwos (adj): alive, living
bjologīa (f): biology
bladan (n): leaf, sheet; blade
blasōn (f): candle, torch
blēdrōn (f): bladder
blēstus (m): blast; gust of wind, burst of wind; breeze
blīθus (adj): joyful, happy, pleasant, pleasing, delightful
blīwan (n): color, hue
blōstran (n): sacrifice
blukkan (n): block, log
blūomi (v): to call
Bomadotōr (m): (proper name) strong leader
Bomajos (m): (proper name) strong metal
Bomartos (m): (proper name) strong bear
Bomaspēs (m): (proper name) prosperous strong
bomastao (v): to stand firmly
Bomistadotōr (m): (proper name) strongest leader
Bomistokretos (m): (proper name) strongest clever
Bomistonēr (m): (proper name) strongest powerful
Bomonēr (m): (proper name) strong powerful
Bomorōn (m): (proper name) strong eagle
bomos (adj): strong, firm, steady
Bomowalpos (m): (proper name) strong wolf
Bomowīk (m): (proper name) strong victory
borom (n): boron
Bosnīa pe Ertsegowīna (f): Bosnia and Herzegovina
brajdos (adj): wide
braksmōn (f): bream
braktos (m): cracking, snapping, crash
braktumos (m): noise
brandos (m): sword
Brasilīa (f): Brazil
brawdan (n): fragment, piece
brēdōn (m): flesh, meat
brēθis (f): odor, smell
breθus (adj): short, brief
bremusis (f): gadfly, horsefly
brestus (m): impairment, handicap
brigdilos (m): strap, rein, bridle
brinkos (m): edge (of land), brink
Britannīa (f): Britain
Britanniskom Imperjom (n): British Empire
brīwos (m): porridge
brōkis (f): leggings, pants, trousers
brugjōn (f): bridge
bruθan (n): broth
bruθomi (v): to bite
brukis (f): breach, fissure, breaking
brūko (v): to use, to make use of, to employ, use, comsume
brunθis (f): being in heat, being horny
brunθjos (adj): in heat, horny
brunnōn (m): source, wellspring, fountain
brus (adj): heavy
būdilos (m): pouch, bag
būkos (m): belly, abdomen
buktis (f): bay (body of water)
būla (f): boil, sore
bulgīa (f): wave
bullōn (m): round object, ball, bowl
būlōn (f): tumor, cancer
bulstros (m): pillow, cushion
bundan (n): bundle
būo (v): to kiss
burgēnsis (m): bourgeois
burgesīa (f): bourgeoisie
burdan (n): board, plank, table
būros (m): room, chamber
burstis (f): bristle
bus (m): cattle, cow
buskos (m): bush, thicket
būsnis (f): command, order, commandment, precept
gagulos (m): sweetwillow, gale, myrtle
gajla (f): gap; gap, chasm, ravine, crevice
galgōn (m): cross
galdran (n): incantation, enchantment, spell
Galīlajos (m): Galileo, Galilean, Galilaeus
galla (m): gall, bile
galmos (m): echo
galo (v): to call out
galōs (m): brother's wife, sister's husband
galus (adj): naked
galφōn (m): glove
gangomi (v): to mock
garba (f): sheaf
garnan (n): yarn
garnisōn (f): garrison
garwa (f): yarrow
gasaljos (m): friend, comrade, mate
gatan (n): hole, opening, passage
gawkos (m): cuckoo
ge (n): letter g
Gela Wojnīa (f): Cold War
gelna (f): snowstorm, blizzard
gelos (adj): cold
generāl (m): general (military)
generālis relātīwitāt (f): general relativity
generālus (adj): general
geōmetrīa (f): geometry
Geōrgjos (m): George
gerda (f): girdle
geris (f): crane (bird)
Germānīa (f): Germany
Germaniska (f): German language
Germaniskom Imperjom (n): German Empire
gerφetis (f): scripture, writing, handwriting, text
gerφetos (adj): written, writing, letter
gerφo (v): to write
Gīslabērtos (m): Gilbert
glaga (f): milk
glajmis (f): glass
glēsōn (m): amber, resin
glexo (v): divertir, to amuse
glōdis (f): glow, heat
gradis (f): hail
Grajkīa (f): Greece
Grajkiska (f): Greek language
grammatika (f): grammar
grammom (n): gram
graptus (m): carving, digging
grawitāt (f): gravity
Grēgorjos (m): Greg, Gregory
grewtan (n): grit
grinda (f): gravel, sand, pebbles
grindis (f): fence
groφos (m): crab
gruppos (m): group
Grusīa (f): Georgia (country)
Gundisālwos (m): Gonzalo
Gwam (m): Guam
dajawēr (m): brother-in-law
dajgos (adj): soft, malleable
dalexonumanjos (adj): long-suffering, patient, long-passioned
dalexos (adj): long
dalja (f): valley
dalkos (m): knife, dagger
dammos (m): dam
Danetiska (f): Danetian language
danθwa (f): tongue
Dānīēl (m): Daniel
danja (f): a flat area, floor
danka (f): pit, hollow
danomi (v): to be acquainted with, conocer
danosto (v): to recognize
danu (n): river
Danu Mississippi (n): Mississippi River
Danu Nīlos (n): Nile River
Danu Tiberis (n): Tiber River
dara (f): injury, damage, harm
data (f): date
datru (n): tear in the eye
datrūo (v): to cry, to shed tears
dawga (f): shade, shadow
Dawīd (m): David
dawos (m): moisture, dew
de (n): letter d
dekam (num): ten
Dekembēr (m): December
deksis (f): right (direction)
Delawer (m): Delaware
demetos (adj): tamed, domesticated
Dēmētrjos (m): Demeter, Dmitri
demo (v): to tame, domesticate
dēmokratīa (f): democratic
denaros (m): palm of the hand, sole of the foot
deneman (n): offspring, seed, descendants
denetis (f): birth, production
denetōr (m): one who begets, produces, parent
Denetwos (m): (proper name) horse tame
deniskos (adj): related, familiar, consanguineal
denomi (v): to beget, to produce, to give birth; to create, to make, to produce
denos (n): race, lineage, type, kind, family
dentis (f): genesis, birth, creation, production; birth, generation (as in family tree)
dentos (num): tenth
denus (m): cheek
deo (v): to bind
despotus (m): master of the house
dēstrūktjōn (f): destruction
Detaspēs (m): (proper name) prosperous good
detodonomi (v): to thank
detodontis (f): thankfulness, gratitude
Detolūkos (m): (proper name) good light
Detorēdus (m): (proper name) good king, good ruler
detos (adj): good, beautiful, lovely, morally good, of good quality, proper
dētos (adj): bound together
detūktom (n): evangelium, evangelion, gospel, good message
deφa (f): jaw
dēxōn (f): jackdaw
digulos (m): pot, melting pot, crucible
dīkīan (n): dike, trench, ditch
dīkos (m): pool, puddle
dīksa (f): justice
dīksjo (v): to judge
dīksjotēr (m): judge, one who judges
dīksomi (v): to point out
dīn (m): day
diskiplīna (f): discipline
diskoθēka (f): discotheque, night club
distriktos (m): district
Distriktos Kolumbīas (m): District of Columbia
Dīwodonos (m): (proper name) gift of god
Dīwoluφos (m): (proper name) lover of god
dīwos (m): god
djaboliskos (adj): diabolic
djabolos (m): devil, diabolos
Djāna (f): Diana
Djudonos (m): (proper name) gift of the sky
djus (m): sky, heaven
Djusθugatēr (f): (proper name) daughter of the sky
Djussūnus (m): (proper name) son of the sky
do (pp): (dat) to; (acc) until, moving until you reach, hasta; (gen) for the benefit of
do (v): to give
dobasto (v): to arrive (by foot), to walk towards
doīa (f): target, destination; direction
dōkos (m): cloth, rag
dokumentom (n): document
dōm (m): household, house
domφīo (v): to count; to calculate; to reckon
domφos (m): number
Donaspēs (m): (proper name) prosperous gift
dono (v): to give
Donodīwos (m): (proper name) gift of god
donom (n): gift
Dononēr (m): (proper name) powerful gift
donos (m): offspring
dontus (m): tooth
donu (n): knee
doru (n): wood, tree; (plural) woods, forest
dotis (f): the act of giving
dotōr (m): giver
drabos (n): dregs, sediment
dranakos (m): baker
dranom (n): grain, bread
drantom (n): mercury
drao (v): to run
drawgos (m): apparition, ghost, delusion
dremo (v): to sleep
drēnus (m): wasp, hornet, drone
drugan (n): dream
drunkis (m): potion
drupōn (m): drop (of liquid)
dūbōn (f): pigeon, dove
dudran (n): egg yolk
dudros (m): dodder
dūīa (f): beauty
dūjos (adj): beautiful
dūketis (f): movement
dukkōn (f): muscle
dūko (v): to lead, to move, to drive, to cause to move, to push
dulgos (m): debt
duljan (n): tube, pipe; nozzle, spout
dultis (f): celebration, festival
dunga (f): dung, manure, fertilizer
dungīōn (f): vault, treasury, subterranean chamber, underground cellar
dūo (num): two
dūs (f): forearm
dusis (f): failure, error, mistake; sin
dūsomi (v): to taste
dūstus (m): taste
dwergos (m): dwarf
dwibrus (m): balance, scale, libra
dwidant (num): twelve
dwidantos (num): twelfth
dwikos (adj): twin, pair
dwimenesjos (adj): double-minded
dwis (num): twice
dwispeltos (adj): double
dwitont (num): twenty
dwitontos (num): twentieth
dwojomi (v): to fear
dwojtos (adj): feared
e (n): letter e
egalos (m): leech
Ēdgār (m): Edgar, Edgardo
edomi (v): to eat
eθus (adj): sharp
ekspressjōn (f): expression
el (n): letter l
ēlektrikitāt (f): electricity
ēlektriskos (adj): electric, electrical
ēlektriskos adros (m): electric field
Elēna (f): Helena
Ēlīa (m): Elijah
Elisabeta (f): Elizabeth, Isabel
ēljom (n): helium
ellekjo (v): to put in, to insert, to place, to collocate
ellūkīo (v): to illuminate
ellūkos (adj): enlightened (mind), wise
ellūφos (adj): sweet, caring, loving
elmos (m): elm, elm tree, elm wood
ēlos (m): eel
elxos (m): elk
em (n): letter m
embasto (v): to walk in, to enter
embīwīo (v): to bring to life, to bring back to life, to revive, to animate
embīwos (adj): alive, living
embos (n): gland
emplūtos (adj): valioso, important
en (n): letter n
en (pp): (loc) in; (acc) inwards, into
energīa (f): energy
enθūmos (adj): hot
enkasnos (adj): evil
enkretos (adj): talented, clever, able
enkrūos (adj): cold, cool
enswadīa (f): sugar
enswennjos (adj): sleepy, tired, fatigued, exhausted
entīomi (v): to live in, to habitate
entītis (f): habitation, residence, settlement
entorpos (adj): happy
entrūdo (v): to impress (press in)
enudros (adj): wet, watery, liquid
enwardīa (f): energy
enwardjos (adj): energetic, active
epastaetēr (m): representative
epastaetis (f): representation
epastao (v): to represent
eperos (m): boar
epi (pp): (loc) at; (ins) near
epipertīo (v): to bring close, to bring near, to draw close, to draw near
epipertus (adj): close, near
epiteletos (adj): closed
epitelo (v): to close
er (n): letter r
ēr (m): goat
erbōn (m): wolverine
erθōbasjan (n): strawberry
Ernustos (m): Ernest, Ernesto
es (n): letter s
Ēsaīa (m): Isaiah
esan (n): flowing blood, live blood
Esdra (m): Ezra, Esdras
Esθēr (f): Esther
Estonīa (f): Estonia
etōn (f): manger
ettis (f): food
etunos (adj): fat, glutton
etwakos (m): horseman, knight, cavalier
Etwodenos (m): (proper name) horse tame
Etwodenotēr (m): (proper name) horse tamer
etwos (m): horse, stallion
Ēwa (f): Eve
ēwolūtjōn (f): evolution
ēwolūtjōnārjos (adj): evolutionary
Ewrōpa (f): Europe
θaksus (m): badger
θalomi (v): to blossom
θāns (f): goose
θastom (n): stick
θaφīomi (v): to perish, to die
θaφītos (adj): dead
θe (n): letter θ
θeātriskos (adj): theatrical
θeātrom (n): theater
θeba (f): fat (grasa)
θejo (v): to suck
θelna (f): pine
θelo (v): to shine
θeo (v): to put
Θeodōros (m): Theodore
θeōrēman (n): theorem
θēr (m): hedgehog
θerna (f): bowels
θersa (f): horror
θersīa (f): courage
θersos (adj): courageous
θerxan (n): thorn
θēs (m): god, deity
Θessalonīka (f): Thessaloniki
θetis (f): act, deed, feat; fact; behavior
θetos (adj): made, done, finished
θeφetos (adj): burnt
θeφo (v): to burn
θīθetis (f): shape, form, nature, quality; nature, natural world
θīθetiskos (adj): natural
θīθo (v): to mold, to shape, to fashion
θīōm (f): winter
θistilos (m): thistle
θjesi (adv): yesterday
θo (v): to do, to make, to cause
Θōma (m): Thomas
Θorsartos (m): (proper name) courageous bear
θorsīa (f): pride
Θorsistartos (m): (proper name) most courageous bear
Θorsistobomos (m): (proper name) most courageous strong
Θorsistotawros (m): (proper name) most courageous bull
Θorsistowalpos (m): (proper name) most courageous wolf
Θorsonēr (m): (proper name) courageous powerful
θorsos (adj): proud
Θorsotawros (m): (proper name) courageous bull
Θorsowalpos (m): (proper name) courageous wolf
θortos (m): enclosure
θrastus (m): thrush
θrīo (v): to defecate
θrūxo (v): to trick, to deceive
θubros (adj): deep
θugatēr (f): daughter
Θugaterdjus (f): (proper name) daughter of the sky
θūlo (v): to pour
θūmatos (adj): foggy, smoky, unclear
θūmos (m): smoke
θūo (v): to run
θurskos (m): cod, codfish
θutomi (v): to invoke
θūxomi (v): to work
θwerjos (adj): wild
θweropeplos (m): wheel of the animals, zodiac, wheel of the zodiac
θweros (m): wild animal, beast, animal
θweso (v): to breathe
θwōr (m): door
i (n): letter i
ibaxis (m): ivy
igilos (m): hedgehog
idea (f): idea
Illinōj (m): Illinois
Immanūēl (m): Immanuel
imperjom (n): empire
ingenjātōr (m): engineer
Indīa (f): India
Indjāna (f): Indiana
īnstitūtom (n): institute
īnstrūktjōn (f): instruction
integrāl (f): integral
īomi (v): to go
īōn (m): ion
Isāk (m): Isaac
Isdrāēl (f): Israel
Ismāēl (m): Ismael
Ispānīa (f): Spain
Ispaniska (f): Spanish language
istorīa (f): history
isus (m): arrow
Ītalīa (f): Italy
Italiska (f): Italian language
īxwos (m): yew
ja (n): letter j
jago (v): to hunt
jadakos (m): priest
jadīo (v): to make holy
jados (adj): holy, saint
Jakōbos (m): Jacob, James, Jack, Jacques
Jānwārjos (m): January
Japonīa (f): Japan
Japoniska (f): Japanese languge
jatomi (v): to ride, to go by riding
je (c): if; binary interrogative particle
jedos (n): ice
jekulos (m): icicle
jenatrōs (m): brother-in-law's wife, sister-in-law's husband
jepan (n): liver
jēr (m): year
Jeremīa (m): Jeremy, Jeremias, Jeremiah
Jerūsalēm (f): Jerusalem
Jesekīēl (m): Ezekiel
jesomi (v): to boil
jestos (adj): boiled
Jēsus (m): Jesus, Joshua
jeti (c): rather, si no que, instead
jewis (f): law
jeφo (v): to copulate, to fuck
Jōānna (m): John, Juan, Jean
Jōānna (f): Juana, Jane
Jōb (m): Job
jōdom (n): iodine
Jōēl (m): Joel
jomīa (f): quantity, amount
Jōna (m): Jonah, Jonas
Jorja (f): Georgia
Jōsēφos (m): Joseph
Jowis (m): Thursday
jugom (n): yoke
jugomi (v): to join, to tie together
jugos (n): team
Jūda (m): Judas
Jūdīt (f): Judith
jūenīa (f): youth
jūenus (adj): young
Jūlja (f): Julia
Jūljos (m): Julius, July
Jūnjos (m): June
justos (m): cheese
Juta (f): Utah
ka (n): letter k
Kabo-Werde (m): Cape Verde
kajkos (adj): blind
Kajsār (m): Caesar
kakka (f): excrement, poop, dung
Kaliφornīa (f): California
kaljom (n): potassium
kalkjom (n): calcium
kalos (adj): handsome
Kanada (f): Canada
kanīa (f): song
kanipos (m): little hairs on the chin or cheek; whiskers
kano (v): to sing
Kansa (f): Kansas
kantis (f): corner
kantom (num): hundred
kantomos (num): hundredth
kapinos (adj): main, chief, principal, head
kapitālismom (n): capitalism
kapitālista (m): capitalist
kapitālistiskos (adj): capitalist
kapjo (v): to grasp, to capture, to understand
kapros (m): goat
kapu (n): head
kār (f): wax
karbōn (m): carbon
Karolos (m): Charles
Kasaxistān (m): Kazakhstan
kasnos (adj): black, dark, dusky, obscure
kasto (v): to throw, to cast, to hurl, to fling
kāt (m): puppy, cub
kebrōn (m): beetle
kedom (n): smoke
kela (f): glue
kelatos (adj): sticky
kelθos (n): baby, infant, fetus
kenga (f): hook
kenkom (n): kneecap
Kentaki (f): Kentucky
kentimetrom (n): centimeter
kentrālus (adj): central
kentrom (n): center
kerpo (v): to pluck
kilogrammom (n): kilogram
kilometrom (n): kilometer
kīmbos (m): pincers
kīmōn (m): sprout
kino (m): cinema, movie theater
Kirgistān (m): Kyrgyzstan
kisilos (m): pebble; kernel of sand; grain of sand
kisnos (m): pine, spruce
klajōn (m): clay
klajwos (m): clover
klassis (f): class
klassiska mēxanika (f): classical mechanics
klassiskos (adj): classical; pertaining to a class, to class
klawa (f): claw
klena (f): maple
klepetos (adj): stolen
klepo (v): to steal
klīo (v): to lean
klūetos (adj): clean, cleaned
klūnis (f): buttocks, hip, gluteus
klūo (v): to clean
Klūobomos (m): (proper name) fame strength
klūomi (v): to hear, to listen
Klūonēr (m): (proper name) fame power
Klūos (m): (proper name) fame
klūos (n): fame
Klūowīk (m): (proper name) famous victory
kobis (f): success
kobjos (adj): successful
kojna (f): grass
Kolorādo (m): Colorado
Kolumbīa (f): Colombia
kommūnismom (n): communism
kommūnista (m): communist
kommūnistiskos (adj): communist
komputa (f): account, cuenta
komputātrom (n): computer
Konnektikut (m): Connecticut
Kōnstantīnopolis (f): Constantinople
Korīa (f): Korea
korom (n): war
koslos (n): hazel
kotus (m): fight, dispute, argument
kotwīo (v): to fight, to dispute, to argue
kradōn (m): basket; craddle
kremom (n): onion
Kretistonēr (m): (proper name) most clever powerful
kretos (adj): intelligent, insightful, clever
krīomi (v): to separate
krosgan (n): lead (metal)
kroska (f): leg
kruan (n): dead blood, raw blood
krūos (adj): raw
kukliskos (adj): cyclical, cyclic, circular
kuklos (m): cycle, wheel, circle
kulamajsōn (f): coal tit (bird)
kūlōn (f): bump, hole (in the road)
Kurān (m): Quran, Koran
Kūrillos (m): Cyril, Cyrillus, Kirill
kurjakom (n): church
kussomi (v): to kiss
kussos (m): kiss
kwantiska mēxanika (adj): quantum mechanics
kwantom (n): quantum (physics)
kwerna (f): millstone, handmill, quern
lajkan (n): game, sport
lajstos (m): track, trace, footprint
lajwarikōn (f): lark
lāks (m): salmon
lamφros (adj): lightweight
landīn (f): waist, loin
lapilos (m): spoon
lasus (adj): eager
latos (n): swamp
Latwīa (f): Latvia
lawga (f): soap
lawgis (m): flame, blaze
lawetos (adj): washed, clean, cleaned
lawkos (m): leek
lawo (v): to wash
lawomi (v): to acquire
lebis (f): lip
lekjo (v): to lay down, to put, to place
lekjos (m): place
Leksajos (m): (proper name) metal protecter
Leksanēr (m): (proper name) powerful protecter
Leksatūtos (m): (proper name) protecter of the people
Leksaxeθomos (m): (proper name) protecter of the world
leksetrīennos (adj): armed, equipped
leksetrīo (v): to arm, to equip, to weaponize
leksetrom (n): weapon, arms
leksikom (n): lexicon
lekso (v): to protect, defend
Leksorēdus (m): (proper name) metal ruler
lektran (n): afterbirth, placenta
lenθa (f): steppe
lenθos (n): kidney
lenos (adj): slow
lenxo (v): to float
leōn (m): lion
Leōnartos (m): Leonhard, Leonardo, Leonard
lesus (adj): bad
Lewi (m): Levi
lewōn (m): scythe, sickle
lewskōn (m): groin
līgomi (v): to jump
līgos (adj): quick, fast, rapid
līdomi (v): to bind
līdonnom (n): book
liθjom (n): lithium
līθomi (v): to lick
līθu (n): cider; strong drink; liquor
līmōn (m): lake
lingwan (n): heather
linda (f): linden tree
linemos (adj): dirty
linepomi (v): to leave
linos (n): flax, linen, cloak, cloth
līpetos (adj): moistened, moist
līpo (v): to moisten
līsos (adj): straight
līttos (adj): bound together
Lītwa (f): Lithuania
Ljōn (f): Lyons
lokus (m): lake
lua (f): louse
Lūdawīg (m): Louis, Lewis, Ludwig, Clovis
lūdo (v): to break
lūθa (f): person
lūθis (f): people
luθomi (v): to arrive
Lūisjāna (f): Louisiana
Lūka (m): Luke
lūkīeman (n): illumination, lights
lukilos (m): key
lūkīo (v): to illuminate
Lūkos (m): (proper name) light
lūkos (m): light
lūks (m): lynx
luksos (m): lynx
Lūnis (m): Monday
lūttos (adj): broken
lūφetis (f): love, affection
lūφo (v): to love
Lūφos (m): (proper name) love
lūφos (m): love
lūxetis (f): lie, falsehood, false claim
luxetjos (adj): false, incorrect
lūxo (v): to lie, to tell a lie, to speak falsely
magīa (f): magic, sorcery, wizardry
magiskos (adj): magical, pertaining to magic or wizardry
magnēsjom (n): magnesium
magnētiskos adros (m): magnetic field
magos (m): magician, wizard, sorcerer
madarōn (f): madder
maθēmatika (f): mathematics
maθēmatikos (adj): mathematical
maθēmatikos (m): mathematician
maθōn (m): maggot
Mājos (m): May
majskan (n): mixture, mash
majsōn (f): titmouse, chickadee
majtīōn (f): ant
majwos (m): gull, seagull
makos (n): pouch
Malaxīa (m): Malachi, Malachias
malmos (m): sand; ore
Manāssis (m): Manasseh, Manasses
mānis (f): moon
manu (n): human, person, mankind, humanity
maran (n): hand
marθros (m): marten
Marīa (f): Mary
marikis (m): celery
Mariland (f): Maryland
mariswīnan (n): mereswine, porpoise, dolphin
Mārkos (m): Mark
marōn (f): nightmare
Mārtis (m): Tuesday
Mārtjos (m): March
Massatsjūset (m): Massachusetts
matēr (f): mother
Matθājos (m): Matthew
mattukos (m): mattock, ploughshare
māxina (f): machine
Medartos (m): (proper name) big bear
medenīa (f): world
medeniskos (adj): worldly, concerning the world
medisos (adj): bigger, greater
Medis Patrīakiska Wojnīa (f): the Great Patriotic War
Medis Wojnīa (f): the Great War
medomi (v): to consider
medūrtis (f): meadowsweet
medus (adj): big, great
meθi (pp): (loc) between, in the middle of; (gen) during, in the middle of (time); (ins) surrounded by, among
meθjos (m): middle
meθu (n): mead
Mejn (f): Maine
mēlan (n): time for eating, meal, dinner
meldomi (v): to milk; to masturbate
melθos (m): lightning
melitatos (adj): viscous
melitu (n): honey
melwan (n): ground corn, wheat; flour
menθetis (f): knowledge, studies, science
menθetiskos (adj): scientific
menθo (v): (active) to teach, to instruct; (passive) to learn, to study
menomi (v): to think; to remember, to recall
menos (n): mind
mēns (m): month
mensos (n): meat
mentis (f): thought; memory, remembrance
menu (n): palm of the hand
meos (pn): mine
Merkuris (m): Wednesday
meromi (v): to die
mertis (f): death
mertos (adj): dead
mesgomi (v): to sink
Mesiko (m): Mexico
metrom (n): meter
mēxanika (f): mechanics
mīθetis (f): urine
mīθo (v): to urinate
mikrometrom (n): micrometer
mikrosekunda (f): microsecond
mikstilos (m): basil, mistletoe
mīktis (f): a blink, blink of an eye, moment, instant
milligrammom (n): milligram
millimetrom (n): millimeter
millisekunda (f): millisecond
Minnesōta (f): Minnesota
minūta (f): minute
mīos (adj): small
misθos (m): fee
mīsos (adj): smaller
Mississīpi (f): Mississippi
Missūri (f): Missouri
Mitsigan (m): Michigan
Mixāēl (m): Michael
Mixaīa (m): Micah, Micas, Michaiah, Michaias
mīxomi (v): to blink
moktis (f): power, ability
mōn (m): neck
monarxa (m): monarch
monarxīa (f): monarchy
monarxista (m): monarchist
Mongolīa (f): Mongolia
Mongoliska (f): Mongolian language
Montāna (f): Montana
morom (n): blackberry
moru (n): sea
Morunepōtus (m): (proper name) grandson of the sea
morwis (f): ant
Mōsis (m): Moses
Moskowīa (f): Moscow
mosxos (m): brain
Moxartos (m): (proper name) able bear
moxīa (f): power, ability
Moxistartos (m): (proper name) most able bear
Moxistonēr (m): (proper name) most able powerful
Moxistorēdus (m): (proper name) most able ruler
moxje (adv): possibly, maybe, perhaps
moxjos (adj): possible
moxomi (v): to be able, poder
mōxōn (m): poppy, poppyseed
moxos (adj): able, powerful
mua (f): fly
mūkos (adj): mute, dumb, foreign, barbarian, unclear, unintelligible
mūlan (n): muzzle
mulda (f): soil, dirt
muniwa (f): minnow
murxōn (f): carrot, parsnip
mūs (m): mouse
musan (n): moss, bog
mūsika (f): music
mūsikos (adj): musical
nabjan (n): beak
nabōgajsos (m): auger
Naθanāēl (m): Nathanael
naktagalōn (f): nightingale
nam (c): because of, for
nanometrom (n): nanometer
nanosekunda (f): nanosecond
nasīnis (f): health
nasīnjos (adj): healthy
nasis (f): nose
nasjan (n): foothill
naskis (m): skin
naspekjennos (adj): unseen, invisible
nastila (f): headband
nastrūīa (f): difficulty, hardship
nastrūjos (adj): hard, difficult
natilōn (f): nettle
natjan (n): net
natrjom (n): sodium
natrjosjo φlūoridom (n): sodium fluoride
natrjosjo xlōridom (n): sodium chloride
natsismom (n): Nazism
natsista (m): Nazi
natsistiskos (adj): Nazi
nātūra (f): nature, natural world
nātūrālus (adj): natural
naudis (f): trouble, distress
Nāūm (m): Nahum, Naoum
nawis (f): boat, ship
nawstan (n): ship-shed, boathouse
nawta (m): sailor
nawtan (n): benefit; profit
ne (adv): negatory particle; no, not
Nebrāska (f): Nebraska
nēdis (f): that which is sown; seam, stitch
nedo (adv): never
neθennos (adj): unfinished, undone, not finished, not done
nēθla (f): needle
nejados (adj): not holy, cursed
nemerintos (adj): immortal, undying
Nēmīa (m): Nehemiah, Nehemias
nemos (n): sacrifice, worship, sacred place, place of worship
nemoxje (adv): impossible
nemoxje (int): impossible!
nemoxjos (adj): impossible
neom (n): neon
neple (adv): no amount
neplus (pn): not many, few
nepom (n): thing
nepos (pn): nothing
nepostjos (adj): neverending, eternal
nepōtis (f): granddaughter
nepōtus (m): grandson
nēr (m): power, force, vital energy
Nerajos (m): (proper name) powerful metal
Nerammōn (m): (proper name) powerful stone
Nerartos (m): (proper name) powerful bear
Neraspēs (m): (proper name) powerful prosperous
Nerbomos (m): (proper name) strong powerful
Neristajos (m): (proper name) most powerful metal
Neristammōn (m): (proper name) most powerful stone
Neristartos (m): (proper name) most powerful bear
Neristobomos (m): (proper name) most powerful strong
Neristoθorsos (m): (proper name) most powerful courageous
Neristokretos (m): (proper name) most powerful intelligent
Neristoplūtos (m): (proper name) most powerful rich
Neristorēdus (m): (proper name) most powerful ruler
Neristotawros (m): (proper name) most powerful bull
Neristowalpos (m): (proper name) most powerful wolf
Nerleksos (m): (proper name) powerful protecter
nerodos (adj): incorrect, not correct, not right; not straight, not right
nerūptos (adj): unbroken, unbreakable
nesom (adv): in no manner
nesomi (v): to meet
nespe (adv): no reason
nete (adv): nowhere
netomi (v): to attain, to reach
netros (m): corpse
netus (adj): dead
Newāda (f): Nevada
newam (num): nine
newandant (num): nineteen
newandantos (num): nineteenth
newantont (num): ninety
newantontos (num): ninetieth
newdos (m): desire, aspiration; drive, urge, striving
newitwodo (adv): some time
newitwople (adv): some amount
newitwos (pn): not all, some
newitwosom (adv): in some way
newitwospe (adv): some reason
newitwote (adv): somewhere
newnos (num): ninth
neφatos (adj): cloudy, misty, foggy, unclear
neφesatos (adj): cloudy
neφos (n): cloud
neφros (m): kidney
neφummenjos (adj): bottomless, without bound, boundless, unfathomable, abyss, abysmal
nexa (f): fingernail
nidwa (f): a sinking, going down, downfall
nīθan (n): hate, envy, malice
Nīkola (m): Nicholas
Nīkolāos (m): Nicholas
nisdos (m): nest
nitriskom surinom (n): nitric acid
nitrogenom (n): nitrogen
nojnos (pn): not one, none
noman (n): name
noptis (f): night
nosjos (pn): ours
Nowembēr (m): November
noφilos (m): navel
nu (c): so, now
nu (adv): now
Nūa Ampsjer (f): New Hampshire
Nūa Jersi (f): New Jersey
Nūa Jork (f): New York
Nūa Sēland (f): New Zealand
nūīa (f): newness, novelty, news (in plural)
Numa (f): (proper name) soul, spirit
numan (n): breath, soul, spirit
nūomi (v): to renew
nūos (adj): new
Nūos Mesiko (m): New Mexico
nupadetīakos (m): rebel
nupadetīetis (f): rebellion
nupadetīo (v): to be insubordinate, to rebel
o (n): letter o
Oājo (m): Ohio
ogu (n): berry
ojnodant (num): eleven
ojnodantos (num): eleventh
ojnomi (v): to join together, to join, to unite
ojnos (num): one
ojntos (adj): joined, united
oju (n): lifetime
ōkeanos (m): ocean
Oklaōma (f): Oklahoma
oksugenom (n): oxygen
oktantont (num): eighty
oktantontos (num): eightieth
okto (num): eight
Oktōbēr (m): October
oktodant (num): eighteen
oktodantos (num): eighteenth
oktos (num): eighth
Olīwa (f): Olivia
olom (n): alder
olos (n): elbow
ombāl (m): charcoal
omban (n): butter, fat
ombanatos (adj): buttery, greasy, oily, fatty
ombetos (adj): annointed
ombo (v): to anoint
omos (n): back, espalda, shoulder
omos (adj): bitter
Oniska Dakōta (f): North Dakota
Oniska Karolīna (f): North Carolina
oniskos (adj): northern
onkatos (adj): bent, not straight
onkos (m): bend, turn
onos (n): load, burden; trial, difficult experience; temptation
ōpis (f): eye
opstrūktjōn (f): obstruction
Oregon (m): Oregon
orθograφīa (f): orthography
orθom (n): testicle
orōn (m): eagle
orsu (n): arse, ass, butt, anus
orφos (m): servant, slave
ōs (f): mouth
osan (n): autumn
osdos (m): branch
Ōsēa (m): Hosea
Ostarrīxis (f): Austria
Ostarrīxungārīa (f): Austriahungary, Austria-Hungary
ostu (n): bone
Oswentsis (f): Auschwitz
otēr (m): intestine
otratos (adj): sharp, acute
otris (f): corner
owis (f): sheep, ram, ewe
ōwos (n): ear
ōφeros (m): shore, coast
paddōn (f): toad
paetēr (m): protector, savior
paetis (f): protection, savation
pajda (f): cloak, tunic, shirt, coat
pajtomi (v): to repossess, to reacquire
pakko (v): to duck
Palajstīna (f): Palestine
palja (f): city
pao (v): to protect, to look after, to care for, to save
papūros (m): paper, papyrus
Parakwarīa (f): Paraguay
parametrīo (v): to parametrize
parametrom (n): parameter
parāta (f): parade
Parīs (f): Paris
parmis (f): grub
partikula (f): particle
partīta (f): party
Partīta Natsi (f): Nazi party
pasomi (v): to cough
pastīa (f): question
pasto (v): to interrogate, to question
pastro (v): to sneeze
patēr (m): father
patrīa (f): fatherland, motherland
patrīakiskos (adj): patriotic, concerning the fatherland or motherland
pawan (n): fire
pawanatos (adj): fiery, burning
Pawlos (m): Paul
pe (n): letter p
pe (c): and
pegan (n): breast
pedanosto (v): to read; to learn
pedomi (v): to tread
pela (f): skin
pelatos (adj): floury, dusty
pelis (f): flour
peltomi (v): to fold
pempe (num): five
pempedantos (num): fifteenth
pempetont (num): fifty
pempetontos (num): fiftieth
Pensilwanīa (f): Pennsylvania
pentagōnom (n): pentagon
pentis (num): five times
pentos (num): fifth
pentos (m): road
peplatos (adj): circular, round
peplos (m): wheel, circle
perajto (v): to maintain, to hold on to, to keep
peraskīdomi (v): to pierce, to cut through
perastaetēr (m): persevering person
perastaetis (f): perseverance
perastao (v): to persevere
perbasto (v): to walk through, to penetrate
perdomi (v): to fart
perθetos (adj): finished
perθo (v): to finish
peri (pp): (ins) around; (acc) going around; (gen) about, topic, concerning
perīomi (v): to pass
permenomi (v): to think through, to brainstorm, to think intensely
perpontōm (m): transcurso, time
perreφomi (v): to equip, to furnish, to arrange, to prepare
persatos (adj): dusty, dirty
persom (n): dust
perta (f): rib
perti (c): otherwise, if not
Perūīa (f): Peru
perūkomi (v): to announce, to send a message, to report
perūktēr (m): messenger, reporter, announcer
perūktis (f): message, report, announcement, letter
peruti (adv): last year
perxlōriskom surinom (n): perchloric acid
pesna (f): heel
pesus (m): penis
petalom (n): leaf, petal
petan (n): feather
peto (v): to take away
petomi (v): to fly
petos (adj): cooked
petris (num): four times
Petros (m): Peter
pettis (f): fate
pettiskos (adj): fateful
petu (n): livestock
petu (n): wealth
peturdant (num): fifteen
peturdantos (num): fourteenth
peturos (num): fourth
peturtont (num): forty
peturtontos (num): fortieth
petwōres (num): four
peweφomi (v): to boast, to brag
pewiter (c): therefore
pīdos (adj): inactive, reluctant, lazy
pīeman (n): payment, wage
pikometrom (n): picometer
pīkos (m): pickaxe
pilosekunda (f): picosecond
Pima (f): (proper name) peace
piman (n): peace, tranquility, rest
Pimoner (m): (proper name) peace powerful
pīo (v): to pay
pipetis (f): drink, refreshment
pipo (v): to drink
pīrāta (m): pirate
pisda (f): vulva
pistis (f): fish
pjeīa (f): quietness, silence
pjeos (adj): quiet
plaggan (n): a piece of cloth, fabric; patch
plakja (f): spot, stain
plako (v): to punch, to strike, to hit
plan (m): plan
plegōn (m): exercise, game
plenos (adj): full
pletīa (f): flat expanse, area; area (geometry); square, plaza
Pletīa Tjananmen (f): Tiananmen Square
pletis (f): flat, plane (geographical feature); plane (geometry)
pletus (adj): flat, broad
pliktis (f): care, concern; duty, responsibility; carefulness, attention
plōtus (m): flood
plūmōn (m): lung
plus (pn): many
plusis (f): flea
Plūtaspēs (m): (proper name) rich prosperity
Plūtonēr (m): (proper name) rich power
plūtos (adj): rich
po (v): to cook
pogu (n): lap
podis (f): foot
podo (adv): when
polītīa (f): state
Polōnīa (f): Poland
pontōm (m): track, path, road, way
pontōmanīter (m): pathfinder
pople (adv): how much, how many
portorikiskos (adj): Puerto Rican
Porto-Riko (m): Puerto Rico
portos (m): pig
positjōn (f): position
posjos (pn): whose
posom (adv): how
posom (c): in a manner that, such that, in a manner such that
pospe (adv): why
posti (pp): (loc) behind; (acc) backwards, in the opposite direction of; (gen) after (time)
postiman (n): end, finish
postīo (v): to finish, to end (transitive)
pote (adv): where
poteros (pn): which
potīa (f): mastery
potinīa (f): sovereignty; state (geopolitical)
potiniskos (adj): national, having to do with the state
potinos (adj): sovereign
potus (m): master
pra (pp): (gen) next to, on the side of; (acc) moving along (the road, river); (ins) compared to, than
pratēr (m): traveller, hiker
prattus (m): boastful talk; deceit, trickery, stratagem, list, cunning
prena (f): whore, slut, prostitute
prepos (n): body
pretīpos (m): face
pretis (f): prayer
preto (v): to pray, to ask
prewnos (m): knitting needle
prīa (f): happiness
prinomi (v): to buy
prīomi (v): to like
prīos (adj): happy
programman (n): program
programmatiskos (adj): programmatic, pertaining to a program
programmatōr (m): programmer
programmo (v): to program
prōduktom (n): product
prōlētārjātos (m): proletariat
prōlētārjos (m): proletarian
prosθesis (f): prosthesis
prosθetiskos (adj): prosthetic, artificial
Prota Medeniska Wojnīa (f): First World War
protos (num): first
prūkomi (v): to preach, proclaim, declare, announce
prūktēr (adj): proclaimer, preacher, declarer, announcer
prūo (v): to jump
prūsetos (adj): frozen
prūso (v): to freeze
pūdis (f): pain
pūdjos (adj): painful
pūkōn (m): hunchback; goblin, spook
pula (f): hair
pūr (f): wheat
rādis (f): root
rādiskos (adj): fundamental, elementary, basic
rajsa (f): ride; journey
rama (f): frame, prop, support
randīōn (m): wren
rapa (f): turnip
rasta (f): rest
ratta (m): rat
rawbos (m): rape, pillage, robbery
rawmos (m): cream
Rāφāēl (m): Raphael
rebīa (f): darkness
rebōn (f): ivy, vine
rebos (adj): dark
redīa (f): kingdom
rēdislīan (n): riddle
redjo (v): to rule
Rēdūlφos (m): Ralph, Raúl
Rēdunēr (m): (proper name) powerful ruler
rēdus (m): king, ruler
relātīwitāt (f): relativity
relātīwos (adj): relative
remos (n): peace, quiet, tranquility
repomi (v): to snatch
reptom (n): building, edifice
rēspūblika (f): republic
rēswa (f): counsel, deliberation
rewolūtjōn (f): revolution
rewolūtjonārjos (adj): revolutionary
reφomi (v): to build, to construct, to erect
ristus (m): joint (anatomy)
Rīxārdos (m): Richard
Rōbertos (m): Robert
robot (m): robot
robotika (f): robotics
robotiskos (adj): robotic
Rod-Ajland (f): Rhode Island
rodīa (f): law; right, rights
rodīgerφetis (f): orthography
rodīredus (m): judge
rodos (adj): straight, correct, appropriate, true
roduktīa (f): grammar
Rōθirīk (m): Rodrigo, Rurik
Rōθjūlφos (m): Rudolph, Rodolph
rōm (m): rum
Rōma (f): Rome
Rōmiskom Imperjom (n): Roman Empire
ros (adj): sharp
Rosa (f): Rosa, Rose
Rōssīa (f): Russia
Rossiska (f): Russian language
Rōssiska Φederatjōn (f): Russian Federation
Rōssiskom Imperjom (n): Russian Empire
rōssiskos (adj): Russian
rūgomi (v): to vomit
Ruθra Pletīa (f): Red Square
ruθros (adj): red
rūktom (n): vomit
rūman (n): cream
rūpomi (v): to break
rūptos (adj): broken
ruskīa (f): reed, rush (plant)
rūsman (n): throat
rustos (m): rust
Rūt (f): Ruth
ruxjos (m): rye
saga (f): saw (tool)
sagjamφeros (adj): flag-bearing
sagjan (n): flag, banner
sagjeman (n): sign, mark, letter, symbol, meaning, significance
sagjo (v): to give a sign, to signify, to mean
sagomi (v): to seek, to search
sagōn (f): story
sadulos (m): saddle
sajdos (m): magic, charm
sajlan (n): rope, cord
sāl (m): salt
salan (n): hall, room
sālatos (adj): salty
salba (f): salve, ointment
salxōn (m): willow, sallow
sam (num): once
sampeltos (adj): single
Samūēl (m): Samuel
Sānktos Jōānna (m): San Juan, Saint John
Sānktos Kits pe Newis (m): Saint Kitts and Nevis
Sānktos Petersburg (m): Saint Petersburg
sapan (n): juice, sap
sarpru (n): silver
sarwan (n): equipment, armor
Sāturnis (m): Saturday
Sawēr (m): Javier
Sawlos (m): Saul
sawsīa (f): thirst, dryness
sawsos (adj): dry
Saxarīa (m): Zacharias, Zechariah, Zachariah
Sebastopolis (f): Sevastopol
seglan (n): sail
segos (n): feast, celebration, party
sedo (v): to wait
sedomi (v): to sit
seklos (m): seat, chair
sektis (num): six times
sektos (num): sixth
sekunda (f): second
sellekjo (v): to put together, to assemble, to build
selpa (f): butter
selpatos (adj): buttery, oily, greasy
sēlus (adj): happy, fortunate; kind, good
selxos (m): seal (animal)
sem (pp): (ins) with
sema (f): summer
semado (v): to conduct, to lead
seman (n): seed
sembasto (v): to walk together, to march
sembomo (v): to confirm
sēmi (adv): half, partially
sēmidīn (m): midday
sēminoptis (f): midnight
sēmis (f): half
semjugomi (v): to unite, to join together
Semjuktās Polītīās Amerikas (f): United States of America
semjuktis (f): union
Semjuktis Sowetiskōm Sokjālistiskōm Rēspūblikōm (f): Union of Soviet Socialist Republics
semjuktos (adj): united, joined
sempatrīakos (m): compatriot
semφeθjo (v): to compete
semφero (v): to bring together, to cause to congregate
semφertis (f): congregation
semφettis (f): competition
senātos (m): senate
sendentis (f): kinship; family
sendetis (f): surrendering, sacrifice (not in the religious context), giving up, price (metaphorical and literal)
sendo (v): to surrender, to give something up
senkotus (m): fight, dispute
senkotwo (v): to fight, to dispute
senos (adj): old
sentis (f): feeling
sentomi (v): to feel (in both emotional and perceptory senses)
sentos (num): seventh
sentrūdo (v): to compress
seo (v): to sow
sepomi (v): to follow
septam (num): seven
septamaka (f): week
septandant (num): seventeen
septandantos (num): seventeenth
septantont (num): seventy
septantontos (num): seventieth
Septembēr (m): September 
seraφīm (m): seraph, seraphim
Serbīa (f): Serbia
Serbiska (f): Serbian language
Sergjos (m): Sergius, Sergei
serpo (v): to creep, crawl, move slowly, slink
sesta (f): hour, time
sewksla (f): addiction, obsession
sexetis (f): (geometry) volume
sexomi (v): to hold
sidra (f): cider
sidus (m): custom, habit, practice; conduct
siktrōn (f): drain, sewer, gutter
silikōn (m): silicon
Simōn (m): Simon
Sina (f): China
sindros (m): metal slag, metal dross
Siniska (f): Chinese language
Siniska Tūtiska Rēspūblika (f): People’s Republic of China
sīo (v): to sift
Sira (m): Sirach, Sira
sisdo (v): to sit down (transitive)
sjampān (m): champagne
sjersu (n): iron, rust
sjūo (v): to sew
sodīn (adv): today
sōθan (n): satisfaction
sokjālismom (n): socialism
sokjālista (m): socialist
sokjālistiskos (adj): socialist
Sōlis (m): Sunday
solos (adj): whole, in totality
som (c): like, just like
somajeri (adv): already, so soon
soman (n): being, essence
somi (v): to be
somos (pn): same ** this is an adj
somos (adj): same, alike
somūkomi (v): to say the same thing as, to agree with, to be in accordance with
Soniska Dakōta (f): South Dakota
Soniska Karolīna (f): South Carolina
soniskos (adj): southern
sosteo (v): to need
sostja (f): need
sostjos (adj): necessary, needed, essential, fundamental
sotan (n): dung, excrement
sōtan (n): soot
sowan (n): sun
Sowandonos (m): (proper name) gift of the sun
Sowetiska Semjuktis (f): Soviet Union
sowetiskos (adj): soviet
Soφīa (f): Sophia
Soφonīa (m): Sophonias, Zephaniah
sūkoφanta (m): sycophant
suktis (m): sickness
sūlis (m): column, pillar
sultīa (f): saltwater, brine
sūltis (m): starvation, death, hunger, famine
sulφōr (m): sulfur
sumblan (n): banquet
sumpos (m): fungus; mushroom
sundan (n): strait
Sūnudjus (m): (proper name) son of the sky
sūnus (m): son
sūos (pn): his
suppōno (v): to suppose
surga (f): worry; sorrow
surinom (n): acid
suros (adj): sour
sustēman (n): system
swadīa (f): sweetness
Swadimelita (f): (proper name) sweet honey
swadus (adj): sweet
swadutērjos (adj): kind-hearted, sweet-hearted, merciful, kind
swalwōn (f): swallow (bird)
swanos (m): swan
swardis (f): oath
swarmos (m): dizziness
sweblos (m): sulphur, sulfur
swegla (f): flute
sweks (num): six
swelomi (v): to burn
swemīa (f): loneliness, solitude
swemīntos (adj): desolating
swemīo (v): to cause to be alone, to desolate
swemjos (adj): alone
swennos (m): sleep, slumber
swepo (v): to sleep
swepomi (v): to throw, send away, send
swerxos (adj): ill, sick
swesdant (num): sixteen
swesdantos (num): sixteenth
swesōr (f): sister
swetura (f): mother-in-law
sweturos (m): father-in-law
swīdomi (v): to sweat
swīo (v): to whistle
swomīa (f): freedom, liberty
swomīa ekspressjones (f): liberty of expression
swomīetēr (m): liberator
swomīo (v): to liberate, to set free
swomos (adj): free, libre
swosjos (pn): theirs
tago (v): to touch
tadetos (adj): hated
tado (v): to hate
tadomi (v): to fall
tajsila (f): thistle, teasel
takkōn (m): spike, thorn
talan (n): reed
tangis (f): tongs, pliers
tappōn (m): plug
targōn (f): edge, rim, border
tarketos (adj): twisted
tarko (v): to twist
tarnos (adj): sharp
tastom (n): tomb, grave
tastoφeθakos (m): gravedigger
tastuka (f): collection of tombs, graves, catacombs
tasus (adj): grey
tatis (f): battle, war
Tatsikistān (m): Tajikistan
tawan (n): tool
tawetos (adj): molten
tawo (v): to melt
Tawrobomos (m): (proper name) strong bull
Tawroθorsos (m): (proper name) courageous bull
Tawronēr (m): (proper name) powerful bull
tawros (m): bull, bison
te (n): letter t
tegus (adj): thick
teknika (f): technique
tekniskos (adj): technical
Teksa (f): Texas
tekstos (m): text
teldan (n): tent, drape
teletīa (f): hideout, escondite
teletis (f): secret
telīa (f): warmth
telo (v): to cover, to hide
telpa (f): space, expanse
telus (adj): warm
templom (n): temple
tengomi (v): to think
tenktis (f): thought
Tennessī (f): Tennessee
tenomi (v): to extend, to stretch, to spread
tentena (f): country, expanse
tenus (adj): thin
tepos (n): heat, warmth
terman (n): boundary, end
termus (m): cherry
ternatos (adj): sharp
ternokapros (m): horned goat
ternom (n): horn
tero (v): to cross over
tersīa (f): thirst
tersus (adj): thirsty
tēru (n): heart
terus (adj): sterile
terwan (n): tar
tetēr (m): grouse
tetragōnom (n): tetragon, quadrilateral
teweros (m): north wind, northwind
tewnan (n): destruction, ruin, damage
Tiberis (m): Tiber
tībran (n): victim
tigulōn (f): tile, brick
tikēr (f): pea
tiktis (f): accusation, crime, charge
Tīmoθeos (m): Timothy
tīno (v): to lie, to settle
tīomi (v): to settle, to populate, to dwell
tītānjom (n): titanium
Titos (m): Titus
to (pp): (gen) of
Tobīa (m): Tobias
todo (adv): then
tolomi (v): to hold up, to lift
tona (f): shell
tonār (m): thunder
tondrena (f): storm
tonos (m): string, chord, fiber
tople (adv): that many, that much
tori (c): therefore, then, thus
torom (n): crow
Torpīa (f): (proper name) happiness, joy
torpīa (f): happiness, satisfaction, joy, pleasure
torpos (adj): satisfied, pleased, happy
torsos (adj): dry
tosom (adv): like that
tospe (adv): because of that, due to that
tote (adv): there
tramjo (v): (+ acc) to play an instrument; (+ acc) to play a role in a story or theatrical play
traomi (v): to mix
tras (pp): (acc) through, across (the river), beyond (the mountain)
traso (v): to run
trebom (n): dwelling
tremo (v): to tremble, to shake
tretos (num): third
trigōnom (n): triangle, trigon
tridant (num): thirteen
tridantos (num): thirteenth
trīes (num): three
tris (num): thrice
trispeltos (adj): triple
tristus (adj): in a bad mood
tritont (num): thirty
tritontos (num): thirtieth
trosdos (m): thrush
trugos (m): trough (for animals)
trūdo (v): to press
trūθos (m): showman, actor, buffoon, jester, clown
Tsile (m): Chile
tsjurro (m): churro
tugilos (m): rein (on a horse)
tundran (n): tinder
tūos (pn): yours
turannīa (f): tyranny
turanniskos (adj): tyrannical
turannos (m): tyrant
Turkīa (f): Turkey
Turkmenistān (m): Turkmenistan
turnos (adj): bitter
tūsjo (v): to spy
tustont (num): myriad
tustontos (num): myriadth
tūta (f): tribe, people
Tūtiska Swomīetra Armāta (f): People’s Liberation Army
tūtiskos (adj): popular
tuφom (n): shoulder
twenos (adj): holy
twisilan (n): fork, bifurcation
twīφlos (m): doubt
twōn (m): dog
u (n): letter u
ubbastīa (f): exodus, walking out, exit, leaving
ubbasto (v): to walk out, to exit, leave
ubbelīa (f): effort, endeavor, the amount of work put into something
ud (pp): (loc) outside
udrogenom (n): hydrogen
udrojōdiskom surinom (n): hydroiodic acid
udros (adj): wet
udroφeros (m): water bearer
udroxlōriskom surinom (n): hydrochloric acid
udūkomi (v): to admit, to confess, to let out (a secret)
udwōpetis (f): outcry, shouting, yelling
udwōpo (v): to shout, to yell, to cry out
ūjom (n): egg
ūkomi (v): to say
Ukraīna (f): Ukraine
uksēn (m): ox
ūktis (f): speech, phrase, saying, proverb, maxim
ullustus (m): apathy, lack of desire
umilitāt (f): humility
ummenomi (v): to forget
Ungārīa (f): Hungary
ūndran (n): wonder, miracle
ūniwersālus (adj): universal
ūniwersom (n): universe
ūnja (f): joy, delight, pleasure, lust
unnos (m): oven, furnace
unwitōn (m): fool, idiot, moron
ūomi (v): to dress
upadetīo (v): to subordinate
upadetis (f): subordination
uper (pp): (loc) on, above, over
uperallenxo (v): to hang (transitive)
uperpretīpos (m): surface
upertolomi (v): to sustain, to hold over, to support
upertoltis (f): a sustain, a support
uperūkomi (v): to yell, to scream
uperφūjo (v): to grow up, to rise
upo (pp): (loc) under
upoīa (f): inferiority
upojos (adj): inferior
upolekjo (v): to place under, to put under; to submit, to subdue, to make subject
upraīa (f): superiority, supremacy
uprajos (adj): superior, supreme
upūkomi (v): to whisper
upūktos (adj): whispered, secret
ūr (f): squirrel
urakān (m): hurricane
Urakwarīa (f): Uruguay
ūrktis (f): deed, act
ūrstis (f): sausage
urtis (f): garden
Usbekistān (m): Uzbekistan
usgōlja (f): pride, arrogance
uslagan (n): fate, destiny
ūsomi (v): to burn
ūstos (adj): burnt
uta (pp): (dat) for the purpose of, for
uti (c): so that, in order that
utros (m): otter
wabjan (n): web, something woven
wagjos (m): wedge
wadan (n): shallow water, ford
waθomi (v): to go
wajgos (m): wall (of a building)
wajdan (n): woad
wajθa (f): hunt, persuit, chase
Wajōmin (m): Wyoming
waksan (n): wax
waktwa (f): watch, vigil
wakwa (f): polynya
wāl (m): fox
walda (f): dyer’s rocket
Waldimiros (m): Vladimir
Waldislawos (m): Vladislav
walena (f): wool
walīa (f): hunger
waljos (adj): hungry
walos (adj): wounded
walpjos (adj): wolf-like
Walpobomos (m): (proper name) strong wolf
Walpoθorsos (m): (proper name) courageous wolf
Walponēr (m): (proper name) powerful wolf
walpos (m): wolf
wandus (f): mole (animal), vole
wantos (m): wind
wapos (adj): bad, evil
wargatrewan (n): gallows
wargiθa (f): curse, doom, condemnation
wargos (m): outlaw, criminal
wardjentos (adj): working, diligent, hardworking, hard working
wardjo (v): to work
wardus (m): guard
warjos (m): inhabitant, citizen
warkis (m): pain
warmis (f): worm
Warsowīa (f): Warsaw
wartōn (f): wart
Wasinton (f): Washington
watomi (v): to fill
wattis (f): journey
we (c): or
wēgiθa (f): lenience, leniency, mercy
wedos (adj): wet
wedran (n): weather
weθo (v): to transport
weleo (v): to wish, to want, to desire
welētis (f): wish, desire, will
welja (f): wish, desire, want, will
welnjos (adj): desired, cherished, dear; dear, expensive
wēlōkitāt (f): velocity
welpetis (f): hope
welpo (v): to hope
Weneris (m): Friday
Wenetjola (f): Venezuela
wēnis (f): hope, expectation, belief
weo (v): to cause to swell
wepo (v): to speak
werdom (n): work
werdus (m): host
werθom (n): word
werjo (v): to believe, to be convinced of
werman (n): time
wermōdos (m): wormwood
Wermōnt (m): Vermont
weros (adj): true
werus (adj): broad
wesbont (num): sixty
wesbontos (num): sixtieth
wesgeros (m): sunset, evening
Wesiska Wirginīa (f): West Virginia
wesiskos (adj): western
wesnos (m): price; worth, value
wesomi (v): to wear
westis (f): clothing, vestimenta
weterānos (m): veteran
wetos (n): season
weφetos (adj): woven
weφo (v): to weave
weφomi (v): to praise
wīdīa (f): wisdom
wīdomi (v): to know, saber
Wīdonēr (m): (proper name) wise powerful
wīdos (adj): wise
wiθiwindōn (f): bindweed
wiθwa (f): widow
wikkōn (m): male witch, warlock, magician, sorcerer, spellcaster, wizard
wīkomi (v): to be victorious over, vencer
wīksila (f): sour cherry
wīktēr (m): victor
wīktis (f): victory
Wiktōr (m): Victor
wīktos (adj): beaten, loser of the battle
Wiljēlmos (m): William, Guillermo, Wilhelm
wīmos (adj): twisty
wimpilos (m): head covering, wimple, veil, scarf
wīnabasjan (n): grape
winθa (f): elm
wīnom (n): wine
Wirginīa (f): Virginia
wiros (m): man
wirtis (m): beerwort; herb, spice
wis (adv): again
wiski (m): whiskey
Wiskōnsin (m): Wisconsin
wīsomi (v): to sprout
wīspotus (m): village chief, landlord, lord
wisūkomi (v): to retell, to tell a story, to narrate
wisūktis (f): narration, story, history
wisundis (m): wesent, bison
Wītastēr (m): (proper name) bright star
Wītawsōs (m): (proper name) bright dawn
witer (pp): (ins) in agreement with; (abl) according to, según
Witera Medeniska Wojnīa (f): Second World War
witeros (num): second
wītis (f): village
Wītodīn (m): (proper name) bright day
wītos (adj): bright
Wītoφlota (f): (proper name) bright flower
wītso (v): to see
wīttis (f): wisdom, knowledge
witwepe (c): even though, although
witwodinjos (adj): daily
witwodo (adv): everywhen
witwople (adv): every many
witwopos (pn): each
witwos (pn): whole (singular), all (plural)
witwosom (adv): in every manner
witwospe (adv): due to everything
witwote (adv): everywhere
wodan (n): water
wojnīa (f): war
wojos (m): soldier
wōpakos (m): spokesperson, portavoz
wōpis (f): voice
wōpo (v): to call, to name (+instrumental)
wopsa (f): wasp
wōr (m): raven
wortis (f): time, vez, instance; turn
wortomi (v): to turn (transitive)
wosan (n): spring (season)
wosjos (pn): y’all’s
wōstinja (f): desert; wilderness
φagetis (f): division, army division, section
φagetos (adj): divided
φago (v): to divide
φadis (f): beech
φados (adj): good
φaθa (f): leg
φajgjos (adj): fey, doomed to die, about to die
φajmīa (f): young woman, maiden, virgin, maid
φajmos (m): foam
φaksan (n): mane
φalga (f): fallow
φalisos (m): cliff
φalkōn (m): falcon
φalōn (f): plain, plain field
φanjan (n): fen, marsh, swamp
φao (v): to shine
φāp (f): bean
φarθa (f): beard
φarīa (f): heat, warmth
φaris (f): spelt
φarnos (m): fern
φaros (adj): warm, hot
φarsis (f): barley
φatan (n): vessel, container
Φawstos (m): Faustus
φe (n): letter φ
Φebrwārjos (m): February
φederatjōn (f): federation
φeθjo (v): to request, to ask for
φeθomi (v): to dig
φelga (f): felly, outer rim of a wheel
φelos (adj): bright, clear; clear, not fogged; clear, obvious
φelowītsetēr (m): clairvoyant
φelowītsetis (f): clairvoyance
φeltos (n): felt
φenθus (adj): thick
φenomi (v): to strike down, to kill, to slay
φentos (adj): murdered, killed
φēra (f): danger
φergunjan (n): forested mountain
φeredom (n): birch
φeretrom (n): bucket; carrier; container
φerθo (v): to protect
φerθom (n): fort
φerθontus (adj): high, tall
φerθus (m): inlet, fjord
φerjos (adj): hot, warm
φero (v): to carry
φersna (f): heel
φeφrus (m): beaver
φīa (f): bee
φīdomi (v): to split, to separate
Φīθetis (f): (proper name) faith
φīθetis (f): trust, faith
φīθetos (adj): trusted
φīθo (v): to trust, to be confident in
Φilēmōn (m): Philemon
Φilippos (m): Philip, Felipe
φilosoφīa (f): philosophy
φilosoφiskos (adj): philosophical
φilosoφos (m): philosopher
φimbulos (m): giant, monster
φinkōn (m): finch
φinna (f): flipper, fin
φirstis (m): summit, peak; post, ridge of a roof
φitrīan (n): wing
φīttos (adj): separated, split
φiφaldōn (f): butterfly, moth
φlajnos (m): point
φlaksan (n): flax
φlaskōn (f): bottle, flask
φlawmos (m): stream, current, eddy
φlena (f): bubble, ball, sphere
φleo (v): to cry
φleo (v): to blow
φlewgōn (f): fly, flying insect
φlīdeman (n): lights
φlīdo (v): to be shining
φlomo (v): to flower, to blossom
Φlorida (f): Florida
φlotatos (adj): flowery, colorful
φlotos (m): flower
φlunθrīōn (f): flatfish, flounder
φlūōr (m): fluorine
φlutōn (m): raft, boat, ship
φogetos (adj): baked, roasted
φogo (v): to bake, roast
φōdran (n): food, nourishment
φōnēman (v): phoneme
φōnētika (f): phonetics
φōnētiskos (adj): phonetic
φōnologīa (f): phonology
φōr (m): thief
φoratos (adj): thievous
φos (pn): how many
φōsφoros (m): phosphorus
Φrankīa (f): France
Φrankiska (f): French language
φrasis (f): phrase
φratēr (m): brother
Φriθurīk (m): Federico, Fredrick, Friedrich
φru (n): bridge
φrūan (n): well, spring, source, fountain
φrujs (f): eyebrow
φrūomi (v): to begin, to start
φruskos (m): frog
φrustos (m): frost
φrūtis (f): beginning, start
φugo (v): to escape, to flee, to run away
φūdo (v): to hit, to strike
φūθos (adj): awake, aware
φūjo (v): to grow, to become
φullan (n): cup, beaker
φummēn (m): bottom
φunkōn (m): spark
φūomi (v): to become
φurna (f): trout
φursos (m): waterfall, torrent
φusika (f): Physics
φusikos (adj): physical
φusikos (m): physicist
φūxetos (adj): bent
φūxo (v): to bend
xa (n): letter x
xabukos (m): hawk
xaglos (m): hail (the precipitation)
xajdos (m): young goat
xajθis (f): heath, wasteland
xajna (f): whetstone
xajstros (m): young tree
xakulos (m): coat
xalmos (m): hay, straw
xalōn (m): tail
xaltra (f): harness, halter
xamaros (m): hammer
xamiθīan (n): shirt
xamma (f): shinbone; the hollow of the knee
xanja (f): hen
xankōn (m): back of the neck
xanōn (m): rooster, cock
xarmōn (m): ermine, weasel
xarta (m): map
xasalos (m): hazel
xasōn (m): hare
xedo (v): to find, to hold
xeθōm (m): earth
Xeθorrēdus (m): (proper name) ruler of the world
xelo (v): to call
xelu (n): tortoise
xēmīa (f): chemistry
xerθran (n): innards, guts, internal organs
xēringos (m): herring
xerutos (m): deer, stag
xeφo (v): to take, to accept; to receive
xexlōn (f): hoarfrost
xlōriskom surinom (n): chloric acid
xlōrom (n): chlorine
xlūo (v): to joke
xostiskos (adj): foreign
xostus (m): stranger
xōφos (m): hoof
xrajgrōn (m): heron
xramusōn (m): ramson, wild garlic, onjon
xrawnos (m): raven
xrēkan (n): saliva, snot
xreman (n): herb, plant
xrenθom (n): beam (structure)
xreo (v): to grow (of plants)
xrēta (f): honeycomb
xrīdrōn (f): sieve
xrīθa (f): seizure
xriθis (m): fever
xrīman (n): soot
xrinθos (n): horned beast
xrīsan (n): twig, sprig, bush
Xristjānos (m): Christian
xrunnos (m): spawn (eggs) of frogs or fish
xrusōn (f): crust
xūbis (f): beehive
xulisa (f): case, covering, shell, pod
xultan (n): gold
xumpōn (m): knot
xuntis (m): nut
xūōn (m): owl
xūros (m): fear
xwajan (n): whey
xwalos (m): whale
xwana (f): angelica (plant)
xwelpos (m): whelp, pup, puppy
xweros (m): kettle
xwīlo (m): to rest
